NO textures/brick.png
WE textures/checker.png
SO textures/grass.png
EA textures/dirt.png
F 18,53,25
C 153,204,255

1111111111
1N00010001
1000000001
1000110001
1000000001
1111100001
1000010001
1011000001
1001000001
1111111111
