NO textures/wolfenstein/bluestone.png

   WE    textures/wolfenstein/colorstone.png
 SO textures/wolfenstein/greystone.png


EA textures/wolfenstein/purplestone.png

    F     0,0,0
C         0,0,0

11111
10001
10101
1N001
111111

